8;8;
12222211
11111112
11111112
11222111
11111121
12111121
12111121
12111121
