9;9;
211111111
211111211
111121211
111121211
111121211
111111211
122211111
111122221
111111111
