8;8;
11111111
11122221
21111111
21211111
21211111
21211121
21111121
12221111
