9;9;
111111111
111111121
111111121
222211121
111111221
111111221
111111111
222111111
111122211
