16;16;
1111111111111111
1111111111111121
1111111111111121
1111111222111121
1111111111111121
1111111111111121
1111111111111111
1111111111111111
1111111111111121
1111111111111121
1111111111111121
1111111111111121
1111222111111111
1111111111111111
2111111111111111
2111111111111111
