12;12;
111111111111
112221111111
111111111111
111121111211
121121111211
121121111111
121121111111
121121111111
111111111111
111112221111
111111111111
111111111111
